Xv, Xv, Xv, Xv, Xv, Xv, Xv, Xv, Xv, Xv, Xv, Xv, Xv, Xv, Xv, Xv, Xv, Xv, Xv, Xv, Xv, Xv, Xv, Xv, Xv, Xv, Xv, Xv, Xv, Xv, Xv, Xv, Xv
Xv, Xv^_fme, Xv^_fme, Xv^_fme, Rd^_fme, Xv^_fme, Ce^_fme, Xv^_fme, Ce^_fme, Xv^_fme, Xv, Xv, Xv, Xv, Xv, Xv, Xv, Xv, Xv, Xv, Xv, Xv, Xv, Xv, Xv, Xv, Xv, Xv, Xv, Xv, Xv, Xv, Xv
Xv, Xv^_fme, Gg^_fme, Gs^_fme, Ce^Ypoa, Xom^_fme, Ce^Eff, Ce^_fme, Ce^_fme, Xv^_fme, Xv, Xv, Xv, Xv, Xv, Xv, Xv, Xv, Xv, Xv, Xv, Xv, Xv, Xv, Xv, Xv, Xv, Xv, Xv, Xv, Xv, Xv, Xv
Gs, Gg^_fme, Ce^Ysta, Ce^Ystc, Ce, Ce, Ce, Ce^Eff, Xom^_fme, Xv^_fme, Xv, Xv, Xv, Xv, Xos, Xos, Xos, Xv, Xv, Xv, Xv, Xv, Xv, Xv, Xv, Xv, Xv, Xv, Xv, Xv, Xv, Xv, Xv
Gs, Ce^Ybox, Ce, Ce, Ce, Ce, Ce, Ce, Rd^_fme, Xv^_fme, Xv, Xv, Xol, Xos, Ior^Ybeb, Iwr^Ytaa, Ior^Ebn, Xos, Xos, Xv, Xv, Xv, Xv, Xv, Xv, Xv, Xv, Xv, Xv, Xv, Xv, Xv, Xv
Hh, Ce, Ce, Ce, Ce, Ce, Ce, Ce^Ysta, Gs^_fme, Xv^_fme, Xos, Xol, Iwr, Ior^Ycsa, Ior, Iwr^Yche, Ior, Iwr^Ybar, Xos, Xv, Xv, Xv, Xv, Xv, Xv, Xv, Xv, Xv, Xv, Xv, Xv, Xv, Xv
Hh, Ce, Ce, Ce, Ce, Ce, Ce, Ce^Ystb, Rd^_fme, Xv^_fme, Xos, Ior^Ypta, Ior, Ior, Ior, Iwr, Xos, Xos, Xv, Xv, Xv, Xv, Xv, Xv, Xv, Xv, Xv, Xv, Xv, Xv, Xv, Xv, Xv
Xv, Hh^_fme, Gs^_fme, Ce, Ce, Ce, Rd^_fme, Rd^_fme, Xv^_fme, Xv^_fme, Xv, Xos, Xos, Iwr, Xos, Ior, Iwr^_fme, Xos^_fme, Xv, Xv, Xv, Xv, Xv, Xv, Xv, Xv, Xv, Xv, Xv, Xv, Xv, Xv, Xv
Xv, Xv^_fme, Xv^_fme, Rd^_fme, Gs^_fme, Rd^_fme, Xv^_fme, Xv^_fme, Xv^_fme, Xv^_fme, Xv^_fme, Xv^_fme, Xv^_fme, Xos^_fme, Xv^_fme, Xos^_fme, Xv^_fme, Xv^_fme, Xv^_fme, Xv^_fme, Xv^_fme, Xv^_fme, Xv^_fme, Xv^_fme, Xv^_fme, Xv^_fme, Xv^_fme, Xv^_fme, Xv^_fme, Xv^_fme, Xv^_fme, Xv^_fme, Xv^_fme
Mm^_fme, Mm^_fme, Mm^_fme, Hh^_fme, Mm^_fme, Hhd^_fme, Hhd^_fme, Hhd^_fme, Hhd^_fme, Hhd^_fme, Hh^_fme, Hh^_fme, Hhd^_fme, Hh^_fme, Hh^_fme, Hh^_fme, Hh^_fme, Hh^_fme, Gs^_fme, Rd^_fme, Rd^_fme, Gg^_fme, Hh^_fme, Mm^_fme, Mm^_fme, Mm^_fme, Mm^_fme, Mm^_fme, Mm^_fme, Mm^_fme, Mm^_fme, Mm^_fme, Mm^_fme
Mm, Mm, Mm, Hhd^Fp, Mm, Hhd^Fp, Hhd, Hhd, Hhd^Fp, Hhd, Hh, Hh, Hhd^Fp, Hh^Fp, Hh, Hh, Hh, Hh, Gs, 2 Rd, 1 Rd, Hh, Hh, Mm, Mm, Mm, Mm, Mm, Mm, Mm, Mm, Mm, Mm
Hh, Mm, Mm, Hhd^Fp, Hhd^Fp, Hhd, Hhd^Fp, Hhd^Fp, Hhd, Hhd^Fp, Hhd, Hhd^Fp, Hhd^Fp, Hh^Fp, Hh, Hh, Gg, Gg, Rd, Rd^Ysp, Gs, Hh, Hh, Hh^Fp, Mm, Mm, Mm, Mm, Mm, Mm, Mm, Mm, Mm
Mm, Mm, Mm, Mm, Mm, Mm, Hhd^Fp, Hhd^Fp, Hhd, Hh, Hh, Hh^Fp, Hh, Hh, Hh, Gg, Gg, Gs, Rd, Rd, Gg, Gg, Gg, Hh, Hh, Mm, Mm, Mm, Mm, Mm, Mm, Mm, Mm
Mm, Mm, Mm, Mm, Hhd, Hhd, Hhd, Hh, Hhd, Hh^Fp, Hh, Hh, Hh^Fp, Hh, Gg, Gg, Rd, Rd, Rd, Gg, Gg, Gg, Ww, Wwf, Ww, Ww, Mm, Mm, Mm, Mm, Mm, Mm, Mm
Mm, Mm, Hhd^Fp, Hhd^Fp, Hhd^Fp, Hh, Hhd^Fp, Hhd, Hh, Hhd, Hh, Hh^Fp, Hh^Fp, Gg, Gs, Gs, Rd, Rd, Gg, Gg, Ww, Ww, Ww, Ww, Ww, Ww, Ww, Mm, Mm, Mm, Mm, Mm, Mm
Mm, Hhd, Hhd^Fp, Hhd, Hh, Hh, Hh^Fp, Hhd^Fp, Hh, Hh^Fp, Hh^Fp, Hh^Fp, Hh^Fp, Gg, Rd, Rd, Rd, Gs, Gg, Gg, Ww, Ww, Ww, Wo, Wo, Ww, Ww, Ww, Mm, Mm, Mm, Mm, Mm
Hhd, Hhd^Fp, Hhd, Hhd, Hhd^Fp, Hhd, Hhd^Fp, Hh, Hh, Hh, Gs, Hh^Fp, Gs, Gs^Yvig, Rd, Rd, Gs, Gg, Gg, Wwf, Ww, Ww, Wo, Wo, Wo, Wo, Ww, Ww, Mm, Mm, Mm, Mm, Mm
Hhd, Hhd, Hh, Hhd, Hh^Fp, Hh^Fp, Hh, Hh, Gg, Gs, Ce, Rd, Rd, Rd, Gg, Gs, Gg, Gg, Gg, Ww, Ww, Ww, Wo, Wo, Wo, Ww, Ww, Ww, Hh, Mm, Mm, Mm, Mm
Hh, Hhd, Hh, Hh^Fp, Hh, Hh, Gs, Gg, Gg, Hh, Rd, Rd, Rd, Gg, Gg, Gg, Ww, Ww, Ww, Ww, Ww, Wo, Ww, Ww, Ww, Ww, Wwf, Gg, Hh, Mm, Mm, Mm, Mm
Hh, Hh, Hh, Hh, Hh^Ebn, Hh, Gs^Eff, Gg^Eff, Gll^Fdf, Gg, Gg, Rd, Gg, Gg, Ww, Wwf, Gg, Gg, Gg, Gg, Gg, Ww, Ww, Ww, Gs, Gg, Gg, Gg, Hh, Hh, Mm, Mm, Mm
Hh, Hh, Gs, Hh, Gg^Eff, Gg^Eff, Gll^Fdf, Gll^Fdf, Gll^Fdf, Gg, Gll^Fdf, Gll^Fdf, Gg, Gg, Ww, Wwf, Gg, Gg, Rb^Gvs, Rb^Ystb, Rb^Ysta, Gg, Rb^Gvs, Gg, Rb^Gvs, Gg, Gs, Hh, Hh, Hh, Mm, Mm, Mm
Hh, Hh, Gg, Gs^Eff, Gll^Fdf, Gll^Fdf, Gll^Fdf, Gll^Fdf, Gll^Fdf, Gll^Fdf, Gll^Fdf, Gg, Ww, Ww, Ww, Ww, Gg, Gs, Rb^Gvs, Rb^Gvs, Rb^Gvs, Rb^Gvs, Rb^Gvs, Rb^Gvs, Gg^Eff, Gs, Hh, Hh, Hh, Hh, Hhd, Mm, Mm
Gg, Gs, Gg^Eff, Gll^Fdf, Gll^Fdf, Gll^Fdf, Gll^Fdf, Gll^Fdf, Gg, Gll^Fdf, Gg, Gg, Ww, Ww, Gg, Gg, Rb^Gvs, Rb^Gvs, Rb^Gvs, Rb^Gvs, Rb^Gvs, Rb^Gvs, Gg^Eff, Gg^Eff, Hh, Hh, Hh, Hhd, Hh, Hhd, Hhd, Mm, Mm
Gg, Gs^Eff, Gll^Fdf, Gll^Fdf, Gll^Fdf, Gll^Fdf, Gg, Gs, Ww, Gg, Ww, Gg, Ww, Gg, Rb, Rb^Gvs, Rb^Gvs, Rb^Gvs, Rb^Gvs, Rb^Gvs, Rb^Gvs, Rb^Gvs, Gs, Gs, Hh, Hh, Hh^Fp, Hhd, Hhd, Hhd^Fp, Hhd, Mm, Mm
Gg, Gs, Gg, Gll^Fdf, Gg, Gg, Ww, Wwf, Gg, Ww, Ww, Ww, Gg^Ysta, Gg, Rb^Gvs, Rb^Gvs, Rb^Gvs, Rb^Gvs, Rb^Gvs, Rb^Gvs, Rb^Gvs, Rb, Gs, Hh, Hhd, Hh, Hh, Hh, Hhd^Fp, Hhd, Mm, Mm, Mm
Ww, Gg, Ww, Gg, Ww, Ww, Gg, Wwf, Wwf, Ww, Gg, Gg^Ystb, Rb^Ystc, Rb^Gvs, Rb^Gvs, Rb^Gvs, Rb^Gvs, Rb^Ysc, Rb^Gvs, Rb^Gvs, Rb^Eff, Gg^Eff, Hh, Hh, Hhd^Fp, Hhd, Mm^Ebn, Hhd^Fp, Hhd^Fp, Mm, Mm, Mm, Mm
Ww, Ww, Gg, Ww, Gg, Gg, Gg, Ww, Gg, Gg, Rb^Gvs, Rb^Gvs, Rb^Gvs, Rb^Gvs, Rb^Gvs, Rb^Gvs, Rb^Gvs, Rb^Gvs, Rb^Gvs, Rb^Gvs, Gg, Hh, Hh, Hhd, Hhd^Fp, Hh^Fp, Hhd, Hh, Mm, Mm, Hhd, Mm, Mm
Gg, Gg, Gg, Gg, Rb^Gvs, Rb^Gvs, Rb^Gvs, Rb, Rb^Gvs, Rb^Gvs, Rb^Gvs, Rb^Gvs, Rb^Gvs, Rb^Gvs, Rb^Gvs, Rb^Gvs, Rb^Gvs, Rb^Gvs, Gg^Eff, Gs^Eff, Hh, Hhd, Hh^Fp, Hh^Fp, Hhd, Hh^Fp, Hhd^Fp, Mm, Hhd, Hhd, Mm, Mm, Hhd
Gg, Gg, Gs, Rb^Gvs, Rb, Rb^Gvs, Rb, Rb^Gvs, Rb, Rb^Gvs, 3 Rb, Rb^Gvs, Rb, Rb^Gvs, Rb, Rb^Gvs, Gg^Eff, Gg^Eff, Gs, Hh, Hhd, Hhd, Hhd, Hh, Mm, Hhd, Hhd, Mm, Mm, Hhd, Mm, Hhd, Hhd
Gg, Gg, Gg, Gg, Gg, Gg, Gg, Gs, Gs, Gs, Gs, Gg, Gg, Gg, Gg, Gg, Gg, Gg, Hh, Hh, Hh, Hh, Hh, Hh, Hh, Hhd, Hhd, Hhd, Hh, Hhd, Hh, Hhd, Hh
