Xv, Xv, Xv, Xv, Xv, Xv, Xv, Xv, Xv, Xv, Xv, Xv, Xv, Xv, Xv, Xv, Xv, Xv, Xv, Xv, Xv, Xv, Xv, Xv
Xv, Xv, Xv, Xv, Xv, Xv, Xv, Xv, Xv, Xv, Xv, Xv, Xv, Xv, Xv, Xv, Xv, Xv, Xv, Xv, Xv, Xv, Xv, Xv
Xv, Xv, Xv, Xv, Xoc, Xv, Xv, Xv, Xv, Xv, Xv, Xv, Xos, Xos, Xos, Xos, Xos, Xos, Xos, Xv, Xv, Xv, Xv, Xv
Xv, Xv, Xoc^Efs, Xoc, Irs^Ytrp, Xoc, Xoc, Xv, Xv, Xv, Xos, Xos, Urb^Yboa, Urb^Ycsa, Urb^Ytad, Urb^Yche, Urb, Urb^Ybob, Urb^Ybob, Xos, Xos, Xv, Xv, Xv
Xv, Xoc^Efs, Irs^Ytad, Irs^Yboa, Irs, Irs^Ybob, Irs^Ybob, Xoc, Xv, Xos, Urb^Yboa, Urb^Yboa, Urb^Ytac, Urb, Urb, Urb, Urb, Urb, Urb^Ytad, Urb^Ybob, Urb^Ybob, Xos, Xv, Xv
Xv, Xoc, Irs, Irs, Irs^Yfo, Irs, Irs, Xoc, Xv, Xos, Urb^Ysrc, Urb, Urb, Urb, Urb, Urb, Urb^Yfo, Urb, Urb, Urb^Yche, Urb^Ebn, Xos, Xv, Xv
Xv, Xoc, Irs^Ychf, Irs, Irs, Irs, Irs^Ebn, Xoc, Xv, Xos, Urb^Ebn, Urb, Urb, Urb, Urb, Urb^Ybar, Urb^Ybox, Urb^Ytaa, Urb^Yal, Urb, Urb^Ypa, Xos, Xv, Xv
Xv, Xoc, Xoc, Irs^Ychf, Irs, Irs, Xoc, Xoc, Xv, Xos, Xos, Urb, Urb^Yar, Urb, Urb, Urb, Urb, Urb, Urb, Urb, Xos, Xos, Xv, Xv
Xv, Xv, Xv, Xoc, Xoc, Irs^Pw/o, Rrc^_fme, Xv^_fme, Xv, Xv, Xv, Xos, Xos, Urb^Ybar, Xos, Urb^Ybox, Xos, Urb^Ybox, Xos, Xos, Xv, Xv, Xv, Xv
Xv, Xv, Xv, Xv, Xv^_fme, Rrc^_fme, Xv^_fme, Xv^_fme, Xv, Xv, Xv, Xv, Xv, Xos, Xv, Xos, Xv, Xos, Xv, Xv, Xv, Xv, Xv, Xv
Xv, Xv, Xv, Xv, Xv, Xv^_fme, Xv, Xv, Xv, Xv, Xv, Xv, Xv, Xv, Xv, Xv, Xv, Xv, Xv, Xv, Xv, Xv, Xv, Xv
Xv, Xv, Xv, Xv, Xv, Xv, Xv, Xv, Xv, Xv, Xv, Xv, Xv, Xv, Xv, Xv, Xv, Xv, Xv, Xv, Xv, Xv, Xv, Xv
Xv, Xv, Xv, Xv, Xv, Xv, Xv, Xv, Xv, Xv, Xv, Xv, Xv, Xv, Xv, Xv, Xv, Xv, Xv, Xv, Xv, Xv, Xv, Xv
Xv, Xv, Xv, Xv, Xv, Xv, Xv, Xv, Xv, Xv, Xv, Xv, Xv, Xv, Xv, Xv, Xv, Xv, Xv, Xv, Xv, Xv, Xv, Xv
